111111111111111111111111111111
100000000000000000000000000001
10000000000000000N000000000001
100000001000101000000000000001
100000001000101000000000000001
100000001000101000000000000001
100000001000101000000000000001
100000001000101000000000000001
100000001000101000000000000001
100000001000101000000000000001
100000001000101000000000000001
100000001000101000000000000001
100000001000101000000000000001
100000001000101000000000000001
100000001000101000000000000001
100000001000101000000000000001
100000001000101000000000000001
100000001000101000000000000001
100000001000101000000000000001
100000001000101000000000000001
100000001000101000000000000001
100000001000101000000000000001
100000001000101000000000000001
100000001000101000000000000001
100000001000101000000000000001
100000001000101000000000000001
100000001000101000000000000001
100000001000101000000000000001
100000001000101000000000000001
100000001000101000000000000001
100000001000101000000000000001
100000001000101000000000000001
100000001000101000000000000001
111111111111111111111111111111